AA	ɑ
AE	æ
AH	ʌ
AO	ɔ
AW	aʊ
AX	ə
AXR	ɚ
AY	aɪ
B	b
CH	tʃ
D	d
DH	ð
DX	ɾ
EH	ɛ
EL	l̩
EM	m̩
EN	n̩
ER	ɝ
EY	eɪ
F	f
G	ɡ
HH	h
IH	ɪ
IX	ɨ
IY	i
JH	dʒ
K	k
L	l
M	m
N	n
NG	ŋ
NX	ɾ̃
OW	oʊ
OY	ɔɪ
P	p
Q	ʔ
R	ɹ
S	s
SH	ʃ
T	t
TH	θ
UH	ʊ
UW	u
UX	ʉ
V	v
W	w
WH	ʍ
Y	j
Z	z
ZH	ʒ
